#### ##
#     #
##### #
#     #
# ### #
# #   #
### ###