#######
      #
##### #
#     #
# ### #
# #   #
### ###